





NO ./textures/bricks.xpm




SO ./textures/metro.xpm










WE ./textures/wallpaper.xpm








EA ./textures/wood.xpm









F 0,255,0











C 225,20,0



















111111111111111111111111
1010101010000000N0000001
101000000000000000000010111
100000000000000000000000001
100000000000000000000000001
100000000000000000000000001
100000000000000000000000001
100000000000000000000000001
100000000000000000000000001
100000000000000000000000001
100000000000000000000000001
100000000000000000000000001
100000000000000000000000001
100000000000000000000000001
100000000000000000000000001
100000000000000000000000001
100000000000000000000000001
100000000000000000000000001
100000000000000000000000001
100000000000000000000000001
100000000000000000000000001
100000000000000000000000001
100000000000000000000000001
100000000000000000000000001
100000000000000000000000001
100000000000000000000000001
100000000000000000000000001
100000000000000000000000001
100000000000111111111111111
100000000001
111101110011
100001 100001
111111111111
     1111111111111111111111
     1000000000000000000001
     1111111111111111111111
     