R 1200 800
NO ./textures/bricks.xpm
SO ./textures/metro.xpm
WE ./textures/wallpaper.xpm
EA ./textures/wood.xpm

F 220,100,0
C 225,30,0

11111111111
10101010101
1010S010111
10000000001
100000000001
111100000011
1000000000001
111111111111