EA ./textures/wood.xpm
NO ./textures/bricks.xpm
F   0 ,  255  ,          0
SO ./textures/metro.xpm
WE       ./textures/wallpaper.xpm

C 225   ,20,0


 111111111111111111111111
101010101000000000000011
101000000000000000000011111
10000000000000000000000001
100000000000000000000000001
1000000000000000000000000011111111
1111111110000000000000000000000001
1000000000000000000000000011111111
1111111110000000000000000000000001
1000000000000000000000000011111111
1000000000000000000000000011111111111111111111111111111111111111111111111111111111111111111111
1000000000000000000000000000000000000000000000000000000000000000000000000000000000000000000001
10000000000000000000000000000000000000000000000000000000000000000000000000000000000000000000S1
100000000000000000000000000000000000000000000000000000000000000000000000000000000000000000001
1000000000000000000000000011111111111111111111111111111111111111111111111111111111111111111111
100000000000000000000000001
100000000000000000000000001
100000000000000000000000001
100000000000000000000000001
100000000000000000000000001
100000000000000000000000001
100000000000000000000000001
100000000000000000000000001
100000000000111111111111111
1000000000011          111111000
1111011100111
100001 100001
1111111111111
         1111111
         1000001
         1000001
         1111111