NO ./textures/bricks.xpm
SO ./textures/metro.xpm
WE ./textures/zizou.xpm
EA ./textures/wood.xpm
F 220,100,0
C 225,30,0

1111111111
10101010101
10100010111
100000000001
1000000000011
111100000011
10000000000S1
1111111111111



