NO ./textures/bricks.xpm
SO ./textures/metro.xpm
WE ./textures/zizou.xpm
EA ./textures/wood.xpm
F 220,100,0
C 225,30,0


11111111111
10101010101
101000101111
1000000000011
1000000000011
1111000000111
10000000000S1
1111111111111