NO ./textures/bricks.xpm
SO ./textures/metro.xpm
WE ./textures/zizou.xpm
EA ./textures/wood.xpm
F 220,100,0
C 225,30,0

1111111111
10101010101
101000101110
100000000001
100000000001
111100000011
10000000000S1
111111111111
                F 220,100,0