NO ./textures/bricks.xpm
SO ./textures/metro.xpm
WE ./textures/zizou.xpm
EA ./textures/wood.xpm
F 220,100,0
C 225,30,0

1111111111
10101010101
10100010111
10000S00001
100000000001
111100000011
1000000000001
111111111111
111111111
10000001
11111111