NO ./textures/greystone.xpm
SO ./textures/redbrick.xpm
EA ./textures/wood.xpm
WE ./textures/wood.xpm
C 155,100,160
F 111,111,111

     111111
11111100000111111
11110000100001111
1100001111000111
1100001111000111
1000011111100000111
100001111100000111
1100011110001111
111000110000111
11110000000111
11111100011111
111111111111